よみがな	勘定科目	名詞
あずかりきん	預り金	名詞
あずかりしききん	預り敷金	名詞
あずかりやちん	預り家賃	名詞
あずけきん	預け金	名詞
いちねんないへんさいよていちょうきかりいれきん	1年内返済予定長期借入金	名詞
いっかつしょうきゃくしさん	一括償却資産	名詞
いやくひん	医薬品	名詞
いりょうようきかいびひん	医療用器械備品	名詞
うけとりしょうひんけん	受取商品券	名詞
うけとりちだい	受取地代	名詞
うけとりてがた	受取手形	名詞
うけとりはいとうきん	受取配当金	名詞
うけとりやちん	受取家賃	名詞
うけとりりそく	受取利息	名詞
うりあげ	売上	名詞
うりあげだか	売上高	名詞
うりあげねびきだか	売上値引高	名詞
うりあげもどりだか	売上戻り高	名詞
うりあげわりびき	売上割引	名詞
うりあげわりもどしだか	売上割戻し高	名詞
うりかけきん	売掛金	名詞
えいぎょうけん	営業権	名詞
えいぎょうけんしょうきゃく	営業権償却	名詞
えいせいひ	衛生費	名詞
えきむしゅうえき	役務収益	名詞
かいかけきん	買掛金	名詞
かいぎひ	会議費	名詞
かいぎょうひ	開業費	名詞
かいはつひ	開発費	名詞
かしだおれそんしつ	貸倒損失	名詞
かしだおれひきあてきん	貸倒引当金	名詞
かしだおれひきあてきんくりいれ	貸倒引当金繰入	名詞
かしだおれひきあてきんくりいれがくがい	貸倒引当金繰入額(外)	名詞
かしだおれひきあてきんくりいれがくはん	貸倒引当金繰入額(販)	名詞
かしだおれひきあてきんもどしいれ	貸倒引当金戻入	名詞
かしだおれひきあてきんもどしいれがく	貸倒引当金戻入額	名詞
かしつけきん	貸付金	名詞
かじしょうひとう	家事消費等	名詞
かりいれきん	借入金	名詞
かりうけきん	仮受金	名詞
かりうけしょうひぜい	仮受消費税	名詞
かりうけしょうひぜいとう	仮受消費税等	名詞
かりばらいきん	仮払金	名詞
かりばらいしょうひぜい	仮払消費税	名詞
かりばらいしょうひぜいとう	仮払消費税等	名詞
かりばらいほうじんぜいとう	仮払法人税等	名詞
かわせさえき	為替差益	名詞
かわせさそん	為替差損	名詞
かんけいがいしゃかぶしき	関係会社株式	名詞
かんけいがいしゃしゅっしきん	関係会社出資金	名詞
かんりひ	管理費	名詞
がいちゅうひ	外注費	名詞
きかいそうち	機械装置	名詞
きしゅしょうひんたなおろしだか	期首商品棚卸高	名詞
きしゅせいひんたなおろしだか	期首製品棚卸高	名詞
きふきん	寄付金	名詞
きまつしょうひんたなおろしだか	期末商品棚卸高	名詞
きまつせいひんたなおろしだか	期末製品棚卸高	名詞
きゅうりょう	給料	名詞
きゅうりょうてあて	給料手当	名詞
くりこしりえきじょうよきん	繰越利益剰余金	名詞
くりのべしさんしょうきゃく	繰延資産償却	名詞
くりのべぜいきんしさん	繰延税金資産	名詞
くりのべぜいきんふさい	繰延税金負債	名詞
くれじっとうりかけきん	クレジット売掛金	名詞
けんきゅうかいはつひ	研究開発費	名詞
けんしゅうひ	研修費	名詞
けんせつかりかんじょう	建設仮勘定	名詞
けんりきん	権利金	名詞
げんかしょうきゃくひ	減価償却費	名詞
げんかしょうきゃくるいけいがく	減価償却累計額	名詞
げんきん	現金	名詞
げんきんかぶそく	現金過不足	名詞
げんざいりょう	原材料	名詞
こうきょうしせつふたんきん	公共施設負担金	名詞
こうぐきぐびひん	工具器具備品	名詞
こうこくせんでんひ	広告宣伝費	名詞
こうこくひ	広告費	名詞
こうさいひ	交際費	名詞
こうせいさいけん	更生債権	名詞
こうちくぶつ	構築物	名詞
こぐちげんきん	小口現金	名詞
こていしさんじょきゃくそん	固定資産除却損	名詞
こていしさんばいきゃくえき	固定資産売却益	名詞
こていしさんばいきゃくそん	固定資産売却損	名詞
さいむめんじょえき	債務免除益	名詞
さいようきょういくひ	採用教育費	名詞
さしいれほしょうきん	差入保証金	名詞
ざっきゅう	雑給	名詞
ざっしゅうにゅう	雑収入	名詞
ざっぴ	雑費	名詞
ざつそんしつ	雑損失	名詞
しいれ	仕入	名詞
しいれだか	仕入高	名詞
しいれねびきだか	仕入値引高	名詞
しいれもどしだか	仕入戻し高	名詞
しいれわりびき	仕入割引	名詞
しいれわりもどしだか	仕入割戻し高	名詞
しかかりひん	仕掛品	名詞
しききん	敷金	名詞
しせつりようけん	施設利用権	名詞
しはらいてがた	支払手形	名詞
しはらいてすうりょう	支払手数料	名詞
しはらいほうしゅうりょう	支払報酬料	名詞
しはらいほけんりょう	支払保険料	名詞
しはらいやちん	支払家賃	名詞
しはらいりそく	支払利息	名詞
しほんきん	資本金	名詞
しほんきんおよびじゅんびきんげんしょうさえき	資本金及び準備金減少差益	名詞
しほんじゅんびきん	資本準備金	名詞
しゃかいほけんりょうあずかりきん	社会保険料預り金	名詞
しゃくちけん	借地権	名詞
しゃりょううんぱんぐ	車両運搬具	名詞
しゃりょうひ	車両費	名詞
しゅうえき	収益	名詞
しゅうぜんひ	修繕費	名詞
しゅざいひ	取材費	名詞
しゅっしきん	出資金	名詞
しゅびょうひ	種苗費	名詞
しょうきゃくさいけんとりたてえき	償却債権取立益	名詞
しょうひん	商品	名詞
しょうひんばいばいえき	商品売買益	名詞
しょうもうひんひ	消耗品費	名詞
しょうよ	賞与	名詞
しょかいひ	諸会費	名詞
しょとくぜいあずかりきん	所得税預り金	名詞
しようけんしさん	使用権資産	名詞
しんかぶしきもうしこみしょうこきん	新株式申込証拠金	名詞
しんぶんとしょひ	新聞図書費	名詞
じぎょうぬしかし	事業主貸	名詞
じぎょうぬしかり	事業主借	名詞
じぎょうぶんりょうはいとうきん	事業分量配当金	名詞
じこかぶしき	自己株式	名詞
じこかぶしきしょぶんさがく	自己株式処分差額	名詞
じこかぶしきもうしこみしょうこきん	自己株式申込証拠金	名詞
じむようひんひ	事務用品費	名詞
じゅうぎょういんあずかりきん	従業員預り金	名詞
じゅうぎょういんたてかえきん	従業員立替金	名詞
じゅんしさん	純資産	名詞
すいどうこうねつひ	水道光熱費	名詞
せいたいしょくきゅうふひよう	[製]退職給付費用	名詞
せいひん	製品	名詞
せったいこうさいひ	接待交際費	名詞
せつびしはらいてがた	設備支払手形	名詞
せんじゅうしゃきゅうよ	専従者給与	名詞
ぜんきそんえきしゅうせいえき	前期損益修正益	名詞
ぜんきそんえきしゅうせいそん	前期損益修正損	名詞
そうりつひ	創立費	名詞
そぜいこうか	租税公課	名詞
そのた	その他	名詞
そのたゆうかしょうけんひょうかさがくきん	その他有価証券評価差額金	名詞
そふとうぇあ	ソフトウェア	名詞
そんえき	損益	名詞
たいしょくきゅうふひきあてきん	退職給付引当金	名詞
たいしょくきゅうふひよう	退職給付費用	名詞
たいしょくきん	退職金	名詞
たいしょくきんかけきん	退職金掛金	名詞
たてかえきん	立替金	名詞
たてもの	建物	名詞
たてものふぞくせつび	建物附属設備	名詞
たんきかしつけきん	短期貸付金	名詞
たんきかりいれきん	短期借入金	名詞
たんきまえばらいひよう	短期前払費用	名詞
ちだいやちん	地代家賃	名詞
ちょうきかしつけきん	長期貸付金	名詞
ちょうきかりいれきん	長期借入金	名詞
ちょうきこていせいよきん	長期固定性預金	名詞
ちょうきたいりゅうさいけん	長期滞留債権	名詞
ちょうきまえばらいひよう	長期前払費用	名詞
ちょうきまえばらいひようしょうきゃく	長期前払費用償却	名詞
ちょうきみばらいきん	長期未払金	名詞
ちょぞうひん	貯蔵品	名詞
ちんしゃくりょう	賃借料	名詞
つうしんひ	通信費	名詞
ていきよきん	定期預金	名詞
てがたかしつけきん	手形貸付金	名詞
てがたかりいれきん	手形借入金	名詞
てがたばいきゃくそん	手形売却損	名詞
でんしきろくさいけん	電子記録債権	名詞
でんしきろくさいむ	電子記録債務	名詞
でんわかにゅうけん	電話加入権	名詞
とうざかりこし	当座借越	名詞
とうざよきん	当座預金	名詞
とうしゆうかしょうけん	投資有価証券	名詞
とうしゆうかしょうけんばいきゃくえき	投資有価証券売却益	名詞
とうしゆうかしょうけんばいきゃくそん	投資有価証券売却損	名詞
とち	土地	名詞
とちさいひょうかさがくきん	土地再評価差額金	名詞
ねんりょうひ	燃料費	名詞
のうぐひ	農具費	名詞
のうやくえいせいひ	農薬衛生費	名詞
のれん	のれん	名詞
のれんしょうきゃく	のれん償却	名詞
はさんこうせいさいけん	破産更生債権	名詞
はっそうひ	発送費	名詞
はんせいひん	半製品	名詞
はんばいそくしんひ	販売促進費	名詞
はんばいてすうりょう	販売手数料	名詞
ひよう	費用	名詞
ひりょうひ	肥料費	名詞
びひん	備品	名詞
ふくさんぶつさぎょうくず	副産物作業くず	名詞
ふくりこうせいひ	福利厚生費	名詞
ふぞくせつび	附属設備	名詞
ふつうよきん	普通預金	名詞
ふわたりてがた	不渡手形	名詞
べっとつみたてきん	別途積立金	名詞
ほうじんぜいじゅうみんぜいおよびじぎょうぜい	法人税・住民税及び事業税	名詞
ほうじんぜいとう	法人税等	名詞
ほうじんぜいとうちょうせいがく	法人税等調整額	名詞
ほうじんぜい・じゅうみんぜいおよびじぎょうぜい（ほうじんぜいとう）	法人税、住民税及び事業税（法人税等）	名詞
ほうていふくりひ	法定福利費	名詞
ほけんつみたてきん	保険積立金	名詞
ほけんりょう	保険料	名詞
ほしょうきん	保証金	名詞
まえうけきん	前受金	名詞
まえうけしゅうえき	前受収益	名詞
まえばらいきん	前払金	名詞
まえばらいひよう	前払費用	名詞
まえばらいやちん    前払家賃    名詞
まえわたしきん	前渡金	名詞
みしゅうかんぷしょうひぜいとう	未収還付消費税等	名詞
みしゅうしゅうえき	未収収益	名詞
みしゅうにゅうきん	未収入金	名詞
みせいこうじししゅつきん	未成工事支出金	名詞
みばらいきん	未払金	名詞
みばらいしょうひぜい	未払消費税	名詞
みばらいしょうひぜいとう	未払消費税等	名詞
みばらいはいとうきん	未払配当金	名詞
みばらいひよう	未払費用	名詞
みばらいほうじんぜいとう	未払法人税等	名詞
みばらいやくいんしょうよ	未払役員賞与	名詞
もといれきん	元入金	名詞
やくいんかりいれきん	役員借入金	名詞
やくいんしょうよ	役員賞与	名詞
やくいんほうしゅう	役員報酬	名詞
ゆうかしょうけん	有価証券	名詞
ゆうかしょうけんばいきゃくえき	有価証券売却益	名詞
ゆうかしょうけんばいきゃくそん	有価証券売却損	名詞
よたくきん	預託金	名詞
よみがな	勘定科目	名詞
りえきじゅんびきん	利益準備金	名詞
りょひこうつうひ	旅費交通費	名詞
りーすしさん	リース資産	名詞
りーすふさいこ	リース負債(固)	名詞
りーすふさいりゅう	リース負債(流)	名詞
りーすりょう	リース料	名詞
わりびきてがた	割引手形	名詞
わりびきりょう	割引料	名詞
